XXXXXXXXXXXXXXXXXXXXXXXXXXXXXXXXXXXXXXXXXXXXXXXXXXX
X X X     X X   X         X     X X X X           X
X X X XXX X X XXXXX XXX X X X XXX X X XXXXXXXXX XXX
X       X       X   X X X X X X     X   X X       X
X XXX XXXXX X XXX XXX X X X XXXXX X X X X X X X XXX
X X X X X   X X       X X X   X X X X X     X X X X
XXX XXX X XXX XXX X XXXXX XXX X X X X XXXXXXX XXX X
X         X X X   X   X X X       X     X X X X   X
X X X XXXXX X XXX XXX X X XXXXXXXXXXX XXX X X XXX X
X X X X             X   X         X X     X X     X
XXXXX XXX XXX XXXXX X X X XXXXX X X XXXXX X XXXXXXX
X   X X   X   X   X X X X X   X X   X       X X   X
XXX X XXX X X XXX X XXX XXX XXXXXXXXX X XXX X X XXX
X X     X X X     X X         X       X X X X X X X
X X XXXXXXX XXX XXXXX XXXXX XXX XXX XXXXX X X X X X
X         X X X X   X X     X   X X   X   X       X
X XXXXXXX XXX XXX XXXXX XXX XXX X X XXX XXXXX X X X
X     X X     X X         X X   X X X X X X   X X X
XXX X X X XXXXX XXXXX XXXXX XXXXX X X X X X X X X X
X   X X             X   X   X     X X       X X X X
XXXXX XXXXXXXXX X XXXXX XXX XXX XXXXX X X XXXXX XXX
X         X     X   X     X X X X   X X X     X   X
X XXX X X X X XXX XXXXXXXXXXX X X X XXXXX X X XXXXX
X X X X X X X X   X     X         X     X X X     X
X X X XXX X X XXXXX X X X XXXXX X X XXXXXXX X XXX X
X X   X X X X X     X X X X X X X X X       X X   X
X XXX X XXX X XXXXX XXXXX X X X X X XXX XXX XXX XXX
X   X   X X X X           X X X X X       X   X X X
XXX XXX X XXXXXXX XXXXXXXXX X XXX X X XXXXXXX XXX X
X     X X             X   X X X X X X   X       X X
XXXXX XXXXXXXXXXXXXXX XXX X X X XXX XXX X X XXX X X
X X               X X X X   X X     X   X X   X   X
X X XXXXX XXXXX X X XXX X XXX X X XXX XXX XXX XXX X
X   X     X   X X       X   X X X   X X   X     X X
X XXXXX XXX X XXX XXX XXXXX X XXX X XXXXX XXXXX XXX
X X X   X   X       X         X   X X     X     X X
XXX XXX XXXXX X X X XXX X XXX X X X XXX X XXXXX X X
X   X       X X X X X   X X     X X X X X X X   X X
X XXX XXX XXXXXXX XXXXXXX XXXXX XXX X X XXX XXX X X
X     X X X           X   X   X   X X X   X X X   X
X XXX X XXX XXX XXX XXXXX X X X X X X X X X X X X X
X X     X   X X X X     X   X X X X   X X X     X X
XXXXX X XXX X X X XXXXXXXXX XXX XXXXXXXXXXXXXXX X X
X X   X X   X   X   X     X X X X X X   X       X X
X XXXXX XXX XXXXX X XXXXX X X X X X X X X XXX XXX X
X       X   X   X X   X   X X X X X   X   X X X X X
XXX XXXXXXXXXXX X X XXX X X X X X XXXXXXXXX X X X X
X   X       X X   X     X X X   X   X X   X   X   X
X X X X XXX X XXXXX XXXXXXX X XXX XXX X XXXXX X X X
X X   X X           X       X   X             X X X
XXXXXXXXXXXXXXXXXXXXXXXXXXXXXXXXXXXXXXXXXXXXXXXXXXX
