XXXXXXXXXXXXXXXXXXXXXXXXXXXXXXXXXXXXXXXXXXXXXXXXXXX
X X       X       X   X         X X X     X   X   X
X X XXXXXXXXX XXX X XXX X XXXXXXX X X X XXXXX XXX X
X     X     X X     X   X X X   X     X           X
X X XXXXXXX XXX XXX XXXXX X X X XXX XXXXXXXXX XXX X
X X         X X   X   X       X X   X   X X X X   X
X XXX XXX X X XXX X X XXXXXXX XXXXXXX XXX X XXX X X
X   X   X X     X X X           X   X     X X X X X
XXXXX XXXXXXXXX X XXXXX XXXXXXXXXXX X X XXX X X X X
X     X X X         X           X X   X X   X X X X
X XXX X X XXX XXXXXXXXX X XXXXXXX X X XXX X X XXX X
X X       X   X     X   X X X X     X   X X       X
XXXXXXX XXXXX XXX XXX XXXXX X X XXXXXXX XXX XXX X X
X X     X     X X   X     X   X X X       X X   X X
X X XXX XXX X X XXX X X X XXX XXX X XXXXX X X X X X
X X X   X X X X X X X X X       X X   X   X X X X X
X X XXX X XXX X X X XXX XXXXXXX X X XXXXX X X XXX X
X X X     X   X X       X     X X X X X   X X   X X
X XXXXXXXXXXXXX XXX XXX XXX X XXX XXX X X X XXX XXX
X       X X           X   X X   X       X   X X   X
XXXXX X X X XXXXX XXX XXX X X XXXXX X XXXXX X XXX X
X   X X         X X X X     X X X   X     X X     X
X XXXXXXXXX X X XXX XXXXX XXX X X X XXX XXXXXXX X X
X   X X   X X X X X X   X X       X X X X   X   X X
X X X XXX X X XXX X X XXX XXX XXX XXX X X X XXX X X
X X   X X   X X   X       X   X       X   X   X X X
XXXXX X XXX XXX XXXXXXXXXXXXX XXXXX X X XXXXX X XXX
X                 X   X   X X X   X X X X     X   X
XXXXXXX XXX XXXXX XXX X X X XXXXX X X XXXXX XXXXX X
X       X     X   X X   X   X X     X   X X   X X X
X XXXXX X X XXXXX X XXXXX XXX XXXXXXXXX X XXX X X X
X   X   X X X X X X X     X   X   X     X     X   X
X XXXXXXX XXX X X X X X X XXX XXX XXX XXX X XXXXXXX
X X   X       X X X   X X X   X X       X X X     X
X X XXX X XXXXX XXXXXXXXX XXX X XXX X XXXXXXXXXXX X
X X     X X X   X       X X       X X     X   X   X
XXXXX XXX X X XXXXXXX X X X X X X XXXXXXX XXX XXX X
X   X X     X   X X   X X X X X X   X   X       X X
X X X XXX X X XXX X XXX X XXX XXXXX X XXXXX XXX X X
X X X X   X   X   X   X       X         X   X   X X
X X X XXXXX XXX XXXXXXX XXX XXXXXXX X XXXXX XXXXX X
X X X X     X   X X X     X     X   X     X       X
XXX XXX XXXXX XXX X XXXXXXXXX X X XXXXX XXX XXXXXXX
X       X X   X   X           X X X X X X         X
X X XXX X X XXX XXX XXXXX XXX X XXX X XXXXXXXXX XXX
X X X   X     X   X     X X   X             X   X X
XXX XXX X X X XXX X XXXXX X XXXXXXX XXXXX XXXXX X X
X X   X   X X X     X     X     X       X         X
X XXXXXXX X XXXXXXX X XXX XXXXX XXX X XXXXX X X XXX
X         X       X X   X   X   X   X     X X X   X
XXXXXXXXXXXXXXXXXXXXXXXXXXXXXXXXXXXXXXXXXXXXXXXXXXX
